{
  "id": "challenge-01",
  "name": "Makwa's Den",
  "description": "A dense forest conceals a single winding trail. Build towers in the rare clearings between ancient trees.",
  "tileSize": 40,
  "cols": 32,
  "rows": 18,
  "tiles": [
    [3,3,7,7,3,3,3,7,3,3,7,3,3,7,3,3,3,7,3,3,7,3,3,3,7,3,3,7,3,3,7,3],
    [3,7,0,0,3,7,3,3,7,3,3,3,7,3,3,7,3,3,7,3,3,7,3,7,3,3,7,3,0,0,7,3],
    [7,0,0,0,0,0,3,7,3,3,7,3,3,7,3,3,7,3,3,7,3,3,3,7,3,3,3,0,0,0,0,7],
    [1,1,1,1,1,1,1,1,1,1,1,1,3,7,0,0,0,0,3,7,3,3,3,7,3,3,7,3,0,0,7,3],
    [7,0,0,0,0,0,3,7,0,0,0,1,7,3,0,0,0,0,7,3,3,7,3,3,7,3,3,7,3,3,3,7],
    [3,7,0,0,0,3,7,3,0,0,0,1,3,0,0,0,0,0,0,3,7,3,3,7,0,0,0,0,3,7,3,3],
    [3,3,7,3,3,7,3,3,7,3,0,1,0,0,0,3,7,0,0,0,3,7,3,0,0,0,0,0,0,3,7,3],
    [7,3,3,0,0,0,3,7,3,3,0,1,1,1,1,1,1,1,1,1,1,1,1,1,1,1,1,0,0,7,3,3],
    [3,7,0,0,0,0,0,3,7,3,3,7,0,0,0,3,7,0,0,0,3,7,3,0,0,0,1,0,0,3,7,3],
    [7,0,0,0,0,0,0,0,3,7,3,3,7,0,0,0,0,0,0,3,7,3,0,0,0,0,1,3,7,3,3,7],
    [3,0,0,0,3,7,0,0,0,3,7,3,3,7,0,0,0,0,3,7,3,3,0,0,0,0,1,7,3,3,7,3],
    [7,3,0,7,3,3,7,0,0,0,3,7,3,3,7,7,3,3,7,3,3,0,0,0,0,0,1,0,0,3,7,3],
    [3,3,7,3,3,7,3,3,0,0,0,3,7,0,0,0,3,7,3,3,0,0,0,0,0,0,1,0,0,0,0,7],
    [7,3,3,0,0,0,3,7,3,0,0,0,0,0,0,0,0,3,7,0,0,0,0,0,0,0,1,1,1,1,1,1],
    [3,7,0,0,0,0,0,3,7,3,3,0,0,0,0,3,7,3,3,7,0,0,0,0,3,7,3,3,0,0,7,3],
    [7,0,0,0,0,0,0,0,3,7,3,3,7,3,3,7,3,3,7,3,3,0,0,3,7,3,3,7,3,3,3,7],
    [3,7,0,0,0,0,0,3,7,3,3,7,3,3,7,3,3,7,3,3,7,3,3,7,3,3,7,3,3,7,3,3],
    [3,3,7,3,3,7,3,3,3,7,3,3,7,3,3,7,3,3,7,3,3,7,3,3,7,3,3,7,3,3,7,3]
  ],
  "waypoints": [
    { "col": 0,  "row": 3  },
    { "col": 11, "row": 3  },
    { "col": 11, "row": 7  },
    { "col": 26, "row": 7  },
    { "col": 26, "row": 13 },
    { "col": 31, "row": 13 }
  ],
  "startingLives": 15,
  "startingGold": 250
}
