{
  "id": "challenge-05",
  "name": "Michi-gami Shore",
  "description": "Two streams of creeps pour in from the great lake's northern and southern shores, converging before the final stretch.",
  "tileSize": 40,
  "cols": 32,
  "rows": 18,
  "tiles": [
    [6,6,8,6,6,8,6,6,8,6,6,8,6,6,8,6,6,8,6,6,8,6,6,8,6,6,8,6,6,8,6,6],
    [3,0,0,0,6,8,6,6,8,6,6,6,8,6,6,8,6,6,8,6,6,8,6,6,8,6,8,6,6,6,0,3],
    [1,1,1,0,0,0,6,8,0,0,0,0,6,8,6,6,8,6,6,8,6,6,8,6,6,8,0,0,0,0,0,3],
    [3,0,1,0,0,0,0,0,0,0,0,0,0,6,8,6,0,0,0,6,8,6,0,0,0,0,0,0,0,0,0,3],
    [3,0,1,1,1,1,1,1,1,1,0,0,0,0,0,0,0,0,0,0,0,0,0,0,0,0,0,0,0,0,0,3],
    [3,0,0,0,0,0,0,0,0,1,0,0,0,0,0,0,0,0,0,0,0,0,0,0,0,0,0,0,0,0,8,6],
    [3,7,0,0,0,0,0,0,0,1,0,0,0,0,0,0,0,0,0,0,0,0,0,0,0,0,0,0,0,6,8,6],
    [7,3,3,0,0,0,0,0,0,1,1,1,1,1,1,1,0,0,0,0,0,0,0,0,0,0,0,0,6,8,6,6],
    [3,7,3,3,0,0,0,0,0,0,0,0,0,0,0,1,0,0,0,0,0,0,0,0,0,0,0,6,8,6,6,8],
    [7,3,7,0,0,0,0,0,0,0,0,0,0,0,0,1,1,1,1,1,1,1,1,1,1,1,1,1,1,1,1,1],
    [3,7,3,3,0,0,0,0,0,0,0,0,0,0,0,1,0,0,0,0,0,0,0,0,0,0,0,6,8,6,6,8],
    [7,3,3,0,0,0,0,0,0,1,1,1,1,1,1,1,0,0,0,0,0,0,0,0,0,0,0,0,6,8,6,6],
    [3,7,0,0,0,0,0,0,0,1,0,0,0,0,0,0,0,0,0,0,0,0,0,0,0,0,0,0,0,6,8,6],
    [3,0,0,0,0,0,0,0,0,1,0,0,0,0,0,0,0,0,0,0,0,0,0,0,0,0,0,0,0,0,8,6],
    [3,0,1,1,1,1,1,1,1,1,0,0,0,0,0,0,0,0,0,0,0,0,0,0,0,0,0,0,0,0,0,3],
    [3,0,1,0,0,0,0,0,0,0,0,0,0,6,8,6,0,0,0,6,8,6,0,0,0,0,0,0,0,0,0,3],
    [1,1,1,0,0,0,6,8,0,0,0,0,6,8,6,6,8,6,6,8,6,6,8,6,6,8,0,0,0,0,0,3],
    [6,6,8,6,6,8,6,6,8,6,6,8,6,6,8,6,6,8,6,6,8,6,6,8,6,6,8,6,6,8,6,6]
  ],
  "waypoints": [
    [
      { "col": 0,  "row": 2  },
      { "col": 2,  "row": 2  },
      { "col": 2,  "row": 4  },
      { "col": 9,  "row": 4  },
      { "col": 9,  "row": 7  },
      { "col": 15, "row": 7  },
      { "col": 15, "row": 9  },
      { "col": 31, "row": 9  }
    ],
    [
      { "col": 0,  "row": 16 },
      { "col": 2,  "row": 16 },
      { "col": 2,  "row": 14 },
      { "col": 9,  "row": 14 },
      { "col": 9,  "row": 11 },
      { "col": 15, "row": 11 },
      { "col": 15, "row": 9  },
      { "col": 31, "row": 9  }
    ]
  ],
  "startingLives": 20,
  "startingGold": 300
}
