{
  "id": "challenge-05",
  "name": "Michi-gami Shore",
  "description": "Two streams of creeps pour in from the great lake's northern and southern shores, converging before the final stretch.",
  "tileSize": 40,
  "cols": 32,
  "rows": 18,
  "tiles": [
    [2,2,2,2,2,2,2,2,2,2,2,2,2,2,2,2,2,2,2,2,2,2,2,2,2,2,2,2,2,2,2,2],
    [2,0,0,0,2,2,2,2,2,2,2,2,2,2,2,2,2,2,2,2,2,2,2,2,2,2,2,2,2,2,0,2],
    [1,1,1,0,0,0,2,2,0,0,0,0,2,2,2,2,2,2,2,2,2,2,2,2,2,2,0,0,0,0,0,2],
    [2,0,1,0,0,0,0,0,0,0,0,0,0,2,2,2,0,0,0,2,2,2,0,0,0,0,0,0,0,0,0,2],
    [2,0,1,1,1,1,1,1,1,1,0,0,0,0,0,0,0,0,0,0,0,0,0,0,0,0,0,0,0,0,0,2],
    [2,0,0,0,0,0,0,0,0,1,0,0,0,0,0,0,0,0,0,0,0,0,0,0,0,0,0,0,0,0,2,2],
    [2,2,0,0,0,0,0,0,0,1,0,0,0,0,0,0,0,0,0,0,0,0,0,0,0,0,0,0,0,2,2,2],
    [2,2,2,0,0,0,0,0,0,1,1,1,1,1,1,1,0,0,0,0,0,0,0,0,0,0,0,0,2,2,2,2],
    [2,2,2,2,0,0,0,0,0,0,0,0,0,0,0,1,0,0,0,0,0,0,0,0,0,0,0,2,2,2,2,2],
    [2,2,2,0,0,0,0,0,0,0,0,0,0,0,0,1,1,1,1,1,1,1,1,1,1,1,1,1,1,1,1,1],
    [2,2,2,2,0,0,0,0,0,0,0,0,0,0,0,1,0,0,0,0,0,0,0,0,0,0,0,2,2,2,2,2],
    [2,2,2,0,0,0,0,0,0,1,1,1,1,1,1,1,0,0,0,0,0,0,0,0,0,0,0,0,2,2,2,2],
    [2,2,0,0,0,0,0,0,0,1,0,0,0,0,0,0,0,0,0,0,0,0,0,0,0,0,0,0,0,2,2,2],
    [2,0,0,0,0,0,0,0,0,1,0,0,0,0,0,0,0,0,0,0,0,0,0,0,0,0,0,0,0,0,2,2],
    [2,0,1,1,1,1,1,1,1,1,0,0,0,0,0,0,0,0,0,0,0,0,0,0,0,0,0,0,0,0,0,2],
    [2,0,1,0,0,0,0,0,0,0,0,0,0,2,2,2,0,0,0,2,2,2,0,0,0,0,0,0,0,0,0,2],
    [1,1,1,0,0,0,2,2,0,0,0,0,2,2,2,2,2,2,2,2,2,2,2,2,2,2,0,0,0,0,0,2],
    [2,2,2,2,2,2,2,2,2,2,2,2,2,2,2,2,2,2,2,2,2,2,2,2,2,2,2,2,2,2,2,2]
  ],
  "waypoints": [
    [
      { "col": 0,  "row": 2  },
      { "col": 2,  "row": 2  },
      { "col": 2,  "row": 4  },
      { "col": 9,  "row": 4  },
      { "col": 9,  "row": 7  },
      { "col": 15, "row": 7  },
      { "col": 15, "row": 9  },
      { "col": 31, "row": 9  }
    ],
    [
      { "col": 0,  "row": 16 },
      { "col": 2,  "row": 16 },
      { "col": 2,  "row": 14 },
      { "col": 9,  "row": 14 },
      { "col": 9,  "row": 11 },
      { "col": 15, "row": 11 },
      { "col": 15, "row": 9  },
      { "col": 31, "row": 9  }
    ]
  ],
  "startingLives": 20,
  "startingGold": 300
}