{
  "id": "challenge-01",
  "name": "Makwa's Den",
  "description": "A dense forest conceals a single winding trail. Build towers in the rare clearings between ancient trees.",
  "tileSize": 40,
  "cols": 32,
  "rows": 18,
  "tiles": [
    [2,2,2,2,2,2,2,2,2,2,2,2,2,2,2,2,2,2,2,2,2,2,2,2,2,2,2,2,2,2,2,2],
    [2,2,0,0,2,2,2,2,2,2,2,2,2,2,2,2,2,2,2,2,2,2,2,2,2,2,2,2,0,0,2,2],
    [2,0,0,0,0,0,2,2,2,2,2,2,2,2,2,2,2,2,2,2,2,2,2,2,2,2,2,0,0,0,0,2],
    [1,1,1,1,1,1,1,1,1,1,1,1,2,2,0,0,0,0,2,2,2,2,2,2,2,2,2,2,0,0,2,2],
    [2,0,0,0,0,0,2,2,0,0,0,1,2,2,0,0,0,0,2,2,2,2,2,2,2,2,2,2,2,2,2,2],
    [2,2,0,0,0,2,2,2,0,0,0,1,2,0,0,0,0,0,0,2,2,2,2,2,0,0,0,0,2,2,2,2],
    [2,2,2,2,2,2,2,2,2,2,0,1,0,0,0,2,2,0,0,0,2,2,2,0,0,0,0,0,0,2,2,2],
    [2,2,2,0,0,0,2,2,2,2,0,1,1,1,1,1,1,1,1,1,1,1,1,1,1,1,1,0,0,2,2,2],
    [2,2,0,0,0,0,0,2,2,2,2,2,0,0,0,2,2,0,0,0,2,2,2,0,0,0,1,0,0,2,2,2],
    [2,0,0,0,0,0,0,0,2,2,2,2,2,0,0,0,0,0,0,2,2,2,0,0,0,0,1,2,2,2,2,2],
    [2,0,0,0,2,2,0,0,0,2,2,2,2,2,0,0,0,0,2,2,2,2,0,0,0,0,1,2,2,2,2,2],
    [2,2,0,2,2,2,2,0,0,0,2,2,2,2,2,2,2,2,2,2,2,0,0,0,0,0,1,0,0,2,2,2],
    [2,2,2,2,2,2,2,2,0,0,0,2,2,0,0,0,2,2,2,2,0,0,0,0,0,0,1,0,0,0,0,2],
    [2,2,2,0,0,0,2,2,2,0,0,0,0,0,0,0,0,2,2,0,0,0,0,0,0,0,1,1,1,1,1,1],
    [2,2,0,0,0,0,0,2,2,2,2,0,0,0,0,2,2,2,2,2,0,0,0,0,2,2,2,2,0,0,2,2],
    [2,0,0,0,0,0,0,0,2,2,2,2,2,2,2,2,2,2,2,2,2,0,0,2,2,2,2,2,2,2,2,2],
    [2,2,0,0,0,0,0,2,2,2,2,2,2,2,2,2,2,2,2,2,2,2,2,2,2,2,2,2,2,2,2,2],
    [2,2,2,2,2,2,2,2,2,2,2,2,2,2,2,2,2,2,2,2,2,2,2,2,2,2,2,2,2,2,2,2]
  ],
  "waypoints": [
    { "col": 0,  "row": 3  },
    { "col": 11, "row": 3  },
    { "col": 11, "row": 7  },
    { "col": 26, "row": 7  },
    { "col": 26, "row": 13 },
    { "col": 31, "row": 13 }
  ],
  "startingLives": 15,
  "startingGold": 250
}