{
  "id": "map-02",
  "name": "Wetland Crossing",
  "description": "A serpentine marsh crossing. Favours AoE towers at chokepoints between strips.",
  "tileSize": 40,
  "cols": 32,
  "rows": 18,
  "tiles": [
    [0,0,0,0,0,0,0,0,0,0,0,0,0,0,0,0,0,0,0,0,0,0,0,0,0,0,0,0,0,0,0,0],
    [0,0,0,0,0,0,0,0,0,0,0,0,0,0,0,0,0,0,0,0,0,0,0,0,0,0,0,0,0,0,0,0],
    [1,1,1,1,1,1,1,1,1,1,1,1,1,1,1,1,1,1,1,1,1,1,1,1,1,1,1,0,0,0,0,0],
    [0,0,0,0,0,0,0,0,0,0,0,0,0,0,0,0,0,0,0,0,0,0,0,0,0,0,1,0,0,0,0,0],
    [0,0,0,0,0,0,0,0,0,0,0,0,0,0,0,0,0,0,0,0,0,0,0,0,0,0,1,0,0,0,0,0],
    [0,0,0,0,0,0,0,0,0,0,0,0,0,0,0,0,0,0,0,0,0,0,0,0,0,0,1,0,0,0,0,0],
    [0,0,0,0,0,0,1,1,1,1,1,1,1,1,1,1,1,1,1,1,1,1,1,1,1,1,1,0,0,0,0,0],
    [0,0,0,0,0,0,1,0,0,0,0,0,0,0,0,0,0,0,0,0,0,0,0,0,0,0,0,0,0,0,0,0],
    [0,0,0,0,0,0,1,0,0,0,0,0,0,0,0,0,0,0,0,0,0,0,0,0,0,0,0,0,0,0,0,0],
    [0,0,0,0,0,0,1,0,0,0,0,0,0,0,0,0,0,0,0,0,0,0,0,0,0,0,0,0,0,0,0,0],
    [0,0,0,0,0,0,1,1,1,1,1,1,1,1,1,1,1,1,1,1,1,1,1,1,1,1,1,0,0,0,0,0],
    [0,0,0,0,0,0,0,0,0,0,0,0,0,0,0,0,0,0,0,0,0,0,0,0,0,0,1,0,0,0,0,0],
    [0,0,0,0,0,0,0,0,0,0,0,0,0,0,0,0,0,0,0,0,0,0,0,0,0,0,1,0,0,0,0,0],
    [0,0,0,0,0,0,0,0,0,0,0,0,0,0,0,0,0,0,0,0,0,0,0,0,0,0,1,0,0,0,0,0],
    [0,0,0,0,0,0,1,1,1,1,1,1,1,1,1,1,1,1,1,1,1,1,1,1,1,1,1,0,0,0,0,0],
    [0,0,0,0,0,0,1,0,0,0,0,0,0,0,0,0,0,0,0,0,0,0,0,0,0,0,0,0,0,0,0,0],
    [0,0,0,0,0,0,1,1,1,1,1,1,1,1,1,1,1,1,1,1,1,1,1,1,1,1,1,1,1,1,1,1],
    [0,0,0,0,0,0,0,0,0,0,0,0,0,0,0,0,0,0,0,0,0,0,0,0,0,0,0,0,0,0,0,0]
  ],
  "waypoints": [
    { "col": 0,  "row": 2  },
    { "col": 26, "row": 2  },
    { "col": 26, "row": 6  },
    { "col": 6,  "row": 6  },
    { "col": 6,  "row": 10 },
    { "col": 26, "row": 10 },
    { "col": 26, "row": 14 },
    { "col": 6,  "row": 14 },
    { "col": 6,  "row": 16 },
    { "col": 33, "row": 16 }
  ],
  "airWaypointPaths": [
    [
      { "col": 0,  "row": 1 },
      { "col": 9,  "row": 3 },
      { "col": 18, "row": 1 },
      { "col": 33, "row": 3 }
    ],
    [
      { "col": 0,  "row": 9 },
      { "col": 8,  "row": 5 },
      { "col": 16, "row": 12 },
      { "col": 24, "row": 5 },
      { "col": 33, "row": 11 }
    ],
    [
      { "col": 0,  "row": 2 },
      { "col": 12, "row": 8 },
      { "col": 24, "row": 14 },
      { "col": 33, "row": 15 }
    ]
  ],
  "startingLives": 20,
  "startingGold": 200
}
