{
  "id": "map-01",
  "name": "Winding Pass",
  "description": "A winding Z-path. Favours single-target and AoE towers at chokepoints.",
  "tileSize": 40,
  "cols": 32,
  "rows": 18,
  "tiles": [
    [3,3,7,7,3,0,0,0,0,0,0,0,5,5,5,0,0,8,8,4,4,4,0,0,0,0,0,0,7,7,3,3],
    [3,3,7,7,3,0,0,0,0,0,0,0,5,5,5,0,0,8,8,4,4,4,0,0,0,0,0,0,7,7,3,3],
    [0,0,0,0,0,0,0,0,0,0,0,0,0,0,0,0,0,0,0,0,0,0,0,0,0,0,0,0,0,0,0,0],
    [0,0,0,0,0,0,0,0,0,0,0,0,5,5,0,0,0,0,0,0,0,0,0,0,0,0,0,0,0,0,0,0],
    [1,1,1,1,1,1,1,1,1,0,0,0,0,0,0,0,1,1,1,1,1,1,1,1,1,0,0,0,0,0,0,0],
    [0,0,0,0,0,0,0,0,1,0,0,0,0,0,0,0,1,0,0,0,0,0,0,0,1,0,0,0,0,0,0,0],
    [0,0,0,0,0,0,0,0,1,0,0,0,0,0,0,0,1,0,0,0,0,0,0,0,1,0,0,0,0,0,0,0],
    [0,0,0,0,0,0,0,0,1,0,4,8,4,0,0,0,1,0,4,8,4,0,0,0,1,0,0,7,7,3,3,0],
    [0,0,0,0,0,0,0,0,1,0,4,8,4,0,0,0,1,0,4,8,4,0,0,0,1,0,0,7,7,3,3,0],
    [0,0,0,0,0,0,0,0,1,0,4,8,4,0,0,0,1,0,4,8,4,0,0,0,1,0,0,7,7,3,3,0],
    [0,0,0,0,0,0,0,0,1,0,0,0,0,0,0,0,1,0,0,0,0,0,0,0,1,0,0,0,0,0,0,0],
    [0,0,0,0,0,0,0,0,1,0,0,0,0,0,0,0,1,0,0,0,0,0,0,0,1,0,0,0,0,0,0,0],
    [0,0,5,5,5,5,0,0,1,0,0,0,0,0,0,0,1,0,6,6,8,8,0,0,1,0,0,0,0,0,0,0],
    [0,0,0,0,0,0,0,0,1,1,1,1,1,1,1,1,1,0,0,0,0,0,0,0,1,1,1,1,1,1,1,1],
    [0,0,0,0,0,0,0,0,0,0,0,0,0,0,0,0,0,0,0,0,0,0,0,0,0,0,0,0,0,0,0,0],
    [7,7,3,3,0,0,0,0,0,0,0,6,6,8,8,0,0,0,0,0,0,0,0,0,0,0,0,0,3,3,7,7],
    [7,7,3,3,0,0,0,0,0,0,0,6,6,8,8,0,0,0,0,0,0,0,0,0,0,0,0,0,3,3,7,7],
    [0,0,0,0,0,0,0,0,0,0,0,6,6,8,8,0,0,0,0,0,0,0,0,0,0,0,0,0,0,0,0,0]
  ],
  "waypoints": [
    {
      "col": 0,
      "row": 4
    },
    {
      "col": 8,
      "row": 4
    },
    {
      "col": 8,
      "row": 13
    },
    {
      "col": 16,
      "row": 13
    },
    {
      "col": 16,
      "row": 4
    },
    {
      "col": 24,
      "row": 4
    },
    {
      "col": 24,
      "row": 13
    },
    {
      "col": 33,
      "row": 13
    }
  ],
  "startingLives": 20,
  "startingGold": 200
}
